11111111111111111111
10001000000100000111
1001E00C000100000111
100P100C000100000111
1000010C000000000111
10000000000000000111
11111111111111111111